"unitid","institution name","year","EFFY2023.Level and degree/certificate-seeking status of student","EFFY2023.Undergraduate or graduate level of student","EFFY2023.Grand total","EFFY2023.Grand total men","EFFY2023.Grand total women","EFFY2023.Hispanic or Latino total","EFFY2023.Hispanic or Latino men","EFFY2023.Hispanic or Latino women","IDX_E12"
"110529","California State Polytechnic University-Pomona","2023","All students total","All students total","29442","15756","13686","15364","7429","7935","-2"
"110529","California State Polytechnic University-Pomona","2023","All students, Undergraduate total","Undergraduate","26692","14485","12207","14161","6899","7262","-2"
"110529","California State Polytechnic University-Pomona","2023","All students, Undergraduate, Degree/certificate-seeking total","Not applicable, undergraduate detail","26473","14409","12064","14090","6887","7203","-2"
"110529","California State Polytechnic University-Pomona","2023","All students, Undergraduate, Degree/certificate-seeking, First-time","Not applicable, undergraduate detail","3657","2029","1628","1956","975","981","-2"
"110529","California State Polytechnic University-Pomona","2023","All students, Undergraduate, Other degree/certificate-seeking","Not applicable, undergraduate detail","22816","12380","10436","12134","5912","6222","-2"
"110529","California State Polytechnic University-Pomona","2023","All students, Undergraduate, Non-degree/certificate-seeking","Not applicable, undergraduate detail","219","76","143","71","12","59","-2"
"110529","California State Polytechnic University-Pomona","2023","All students, Graduate","Graduate","2750","1271","1479","1203","530","673","-2"
"110529","California State Polytechnic University-Pomona","2023","All students, Undergraduate, Other degree/certificate-seeking, Transfer-ins","Not applicable, undergraduate detail","3009","1546","1463","1708","767","941","-2"
"110529","California State Polytechnic University-Pomona","2023","All students, Undergraduate, Other degree/certificate-seeking, Continuing","Not applicable, undergraduate detail","19807","10834","8973","10426","5145","5281","-2"
"110529","California State Polytechnic University-Pomona","2023","Full-time students total","Not applicable, undergraduate detail","23061","12314","10747","12096","5793","6303","-2"
"110529","California State Polytechnic University-Pomona","2023","Full-time students, Undergraduate total","Not applicable, undergraduate detail","21871","11836","10035","11547","5596","5951","-2"
"110529","California State Polytechnic University-Pomona","2023","Full-time students, Undergraduate, Degree/certificate-seeking total","Not applicable, undergraduate detail","21847","11825","10022","11547","5596","5951","-2"
"110529","California State Polytechnic University-Pomona","2023","Full-time students, Undergraduate, Degree/certificate-seeking, First-time","Not applicable, undergraduate detail","3577","1984","1593","1902","948","954","-2"
"110529","California State Polytechnic University-Pomona","2023","Full-time students, Undergraduate, Degree/certificate-seeking, Other degree/certificate-seeking","Not applicable, undergraduate detail","18270","9841","8429","9645","4648","4997","-2"
"110529","California State Polytechnic University-Pomona","2023","Full-time students, Undergraduate, Non-degree/certificate-seeking","Not applicable, undergraduate detail","24","11","13","0","0","0","-2"
"110529","California State Polytechnic University-Pomona","2023","Full-time students, Graduate","Not applicable, undergraduate detail","1190","478","712","549","197","352","-2"
"110529","California State Polytechnic University-Pomona","2023","Full-time students, Undergraduate, Other degree/certificate-seeking, Transfer-ins","Not applicable, undergraduate detail","2699","1411","1288","1538","703","835","-2"
"110529","California State Polytechnic University-Pomona","2023","Full-time students, Undergraduate, Other degree/certificate-seeking, Continuing","Not applicable, undergraduate detail","15571","8430","7141","8107","3945","4162","-2"
"110529","California State Polytechnic University-Pomona","2023","Part-time students total","Not applicable, undergraduate detail","6381","3442","2939","3268","1636","1632","-2"
"110529","California State Polytechnic University-Pomona","2023","Part-time students, Undergraduate total","Not applicable, undergraduate detail","4821","2649","2172","2614","1303","1311","-2"
"110529","California State Polytechnic University-Pomona","2023","Part-time students, Undergraduate, Degree/certificate-seeking total","Not applicable, undergraduate detail","4626","2584","2042","2543","1291","1252","-2"
"110529","California State Polytechnic University-Pomona","2023","Part-time students, Undergraduate, Degree/certificate-seeking, First-time","Not applicable, undergraduate detail","80","45","35","54","27","27","-2"
"110529","California State Polytechnic University-Pomona","2023","Part-time students, Undergraduate, Degree/certificate-seeking, Other degree/certificate-seeking","Not applicable, undergraduate detail","4546","2539","2007","2489","1264","1225","-2"
"110529","California State Polytechnic University-Pomona","2023","Part-time students, Undergraduate, Non-degree/certificate-seeking","Not applicable, undergraduate detail","195","65","130","71","12","59","-2"
"110529","California State Polytechnic University-Pomona","2023","Part-time students, Graduate","Not applicable, undergraduate detail","1560","793","767","654","333","321","-2"
"110529","California State Polytechnic University-Pomona","2023","Part-time students, Undergraduate, Other degree/certificate-seeking, Transfer-ins","Not applicable, undergraduate detail","310","135","175","170","64","106","-2"
"110529","California State Polytechnic University-Pomona","2023","Part-time students, Undergraduate, Other degree/certificate-seeking, Continuing","Not applicable, undergraduate detail","4236","2404","1832","2319","1200","1119","-2"
"110547","California State University-Dominguez Hills","2023","All students total","All students total","18253","6792","11461","12184","4396","7788","-2"
"110547","California State University-Dominguez Hills","2023","All students, Undergraduate total","Undergraduate","15412","5936","9476","10874","4067","6807","-2"
"110547","California State University-Dominguez Hills","2023","All students, Undergraduate, Degree/certificate-seeking total","Not applicable, undergraduate detail","15267","5882","9385","10813","4046","6767","-2"
"110547","California State University-Dominguez Hills","2023","All students, Undergraduate, Degree/certificate-seeking, First-time","Not applicable, undergraduate detail","2065","920","1145","1656","741","915","-2"
"110547","California State University-Dominguez Hills","2023","All students, Undergraduate, Other degree/certificate-seeking","Not applicable, undergraduate detail","13202","4962","8240","9157","3305","5852","-2"
"110547","California State University-Dominguez Hills","2023","All students, Undergraduate, Non-degree/certificate-seeking","Not applicable, undergraduate detail","145","54","91","61","21","40","-2"
"110547","California State University-Dominguez Hills","2023","All students, Graduate","Graduate","2841","856","1985","1310","329","981","-2"
"110547","California State University-Dominguez Hills","2023","All students, Undergraduate, Other degree/certificate-seeking, Transfer-ins","Not applicable, undergraduate detail","2585","953","1632","1683","575","1108","-2"
"110547","California State University-Dominguez Hills","2023","All students, Undergraduate, Other degree/certificate-seeking, Continuing","Not applicable, undergraduate detail","10617","4009","6608","7474","2730","4744","-2"
"110547","California State University-Dominguez Hills","2023","Full-time students total","Not applicable, undergraduate detail","12487","4703","7784","8753","3179","5574","-2"
"110547","California State University-Dominguez Hills","2023","Full-time students, Undergraduate total","Not applicable, undergraduate detail","10930","4249","6681","8030","3014","5016","-2"
"110547","California State University-Dominguez Hills","2023","Full-time students, Undergraduate, Degree/certificate-seeking total","Not applicable, undergraduate detail","10911","4242","6669","8030","3014","5016","-2"
"110547","California State University-Dominguez Hills","2023","Full-time students, Undergraduate, Degree/certificate-seeking, First-time","Not applicable, undergraduate detail","1911","841","1070","1537","679","858","-2"
"110547","California State University-Dominguez Hills","2023","Full-time students, Undergraduate, Degree/certificate-seeking, Other degree/certificate-seeking","Not applicable, undergraduate detail","9000","3401","5599","6493","2335","4158","-2"
"110547","California State University-Dominguez Hills","2023","Full-time students, Undergraduate, Non-degree/certificate-seeking","Not applicable, undergraduate detail","19","7","12","0","0","0","-2"
"110547","California State University-Dominguez Hills","2023","Full-time students, Graduate","Not applicable, undergraduate detail","1557","454","1103","723","165","558","-2"
"110547","California State University-Dominguez Hills","2023","Full-time students, Undergraduate, Other degree/certificate-seeking, Transfer-ins","Not applicable, undergraduate detail","1801","709","1092","1190","436","754","-2"
"110547","California State University-Dominguez Hills","2023","Full-time students, Undergraduate, Other degree/certificate-seeking, Continuing","Not applicable, undergraduate detail","7199","2692","4507","5303","1899","3404","-2"
"110547","California State University-Dominguez Hills","2023","Part-time students total","Not applicable, undergraduate detail","5766","2089","3677","3431","1217","2214","-2"
"110547","California State University-Dominguez Hills","2023","Part-time students, Undergraduate total","Not applicable, undergraduate detail","4482","1687","2795","2844","1053","1791","-2"
"110547","California State University-Dominguez Hills","2023","Part-time students, Undergraduate, Degree/certificate-seeking total","Not applicable, undergraduate detail","4356","1640","2716","2783","1032","1751","-2"
"110547","California State University-Dominguez Hills","2023","Part-time students, Undergraduate, Degree/certificate-seeking, First-time","Not applicable, undergraduate detail","154","79","75","119","62","57","-2"
"110547","California State University-Dominguez Hills","2023","Part-time students, Undergraduate, Degree/certificate-seeking, Other degree/certificate-seeking","Not applicable, undergraduate detail","4202","1561","2641","2664","970","1694","-2"
"110547","California State University-Dominguez Hills","2023","Part-time students, Undergraduate, Non-degree/certificate-seeking","Not applicable, undergraduate detail","126","47","79","61","21","40","-2"
"110547","California State University-Dominguez Hills","2023","Part-time students, Graduate","Not applicable, undergraduate detail","1284","402","882","587","164","423","-2"
"110547","California State University-Dominguez Hills","2023","Part-time students, Undergraduate, Other degree/certificate-seeking, Transfer-ins","Not applicable, undergraduate detail","784","244","540","493","139","354","-2"
"110547","California State University-Dominguez Hills","2023","Part-time students, Undergraduate, Other degree/certificate-seeking, Continuing","Not applicable, undergraduate detail","3418","1317","2101","2171","831","1340","-2"
"110583","California State University-Long Beach","2023","All students total","All students total","43106","17863","25243","20850","7973","12877","-2"
"110583","California State University-Long Beach","2023","All students, Undergraduate total","Undergraduate","36021","15088","20933","17913","6988","10925","-2"
"110583","California State University-Long Beach","2023","All students, Undergraduate, Degree/certificate-seeking total","Not applicable, undergraduate detail","35738","14983","20755","17865","6973","10892","-2"
"110583","California State University-Long Beach","2023","All students, Undergraduate, Degree/certificate-seeking, First-time","Not applicable, undergraduate detail","5386","2104","3282","2870","1059","1811","-2"
"110583","California State University-Long Beach","2023","All students, Undergraduate, Other degree/certificate-seeking","Not applicable, undergraduate detail","30352","12879","17473","14995","5914","9081","-2"
"110583","California State University-Long Beach","2023","All students, Undergraduate, Non-degree/certificate-seeking","Not applicable, undergraduate detail","283","105","178","48","15","33","-2"
"110583","California State University-Long Beach","2023","All students, Graduate","Graduate","7085","2775","4310","2937","985","1952","-2"
"110583","California State University-Long Beach","2023","All students, Undergraduate, Other degree/certificate-seeking, Transfer-ins","Not applicable, undergraduate detail","5521","2384","3137","2845","1127","1718","-2"
"110583","California State University-Long Beach","2023","All students, Undergraduate, Other degree/certificate-seeking, Continuing","Not applicable, undergraduate detail","24831","10495","14336","12150","4787","7363","-2"
"110583","California State University-Long Beach","2023","Full-time students total","Not applicable, undergraduate detail","33532","13678","19854","16207","6107","10100","-2"
"110583","California State University-Long Beach","2023","Full-time students, Undergraduate total","Not applicable, undergraduate detail","29381","12050","17331","14619","5595","9024","-2"
"110583","California State University-Long Beach","2023","Full-time students, Undergraduate, Degree/certificate-seeking total","Not applicable, undergraduate detail","29236","12001","17235","14619","5595","9024","-2"
"110583","California State University-Long Beach","2023","Full-time students, Undergraduate, Degree/certificate-seeking, First-time","Not applicable, undergraduate detail","5281","2053","3228","2809","1036","1773","-2"
"110583","California State University-Long Beach","2023","Full-time students, Undergraduate, Degree/certificate-seeking, Other degree/certificate-seeking","Not applicable, undergraduate detail","23955","9948","14007","11810","4559","7251","-2"
"110583","California State University-Long Beach","2023","Full-time students, Undergraduate, Non-degree/certificate-seeking","Not applicable, undergraduate detail","145","49","96","0","0","0","-2"
"110583","California State University-Long Beach","2023","Full-time students, Graduate","Not applicable, undergraduate detail","4151","1628","2523","1588","512","1076","-2"
"110583","California State University-Long Beach","2023","Full-time students, Undergraduate, Other degree/certificate-seeking, Transfer-ins","Not applicable, undergraduate detail","4524","1933","2591","2296","896","1400","-2"
"110583","California State University-Long Beach","2023","Full-time students, Undergraduate, Other degree/certificate-seeking, Continuing","Not applicable, undergraduate detail","19431","8015","11416","9514","3663","5851","-2"
"110583","California State University-Long Beach","2023","Part-time students total","Not applicable, undergraduate detail","9574","4185","5389","4643","1866","2777","-2"
"110583","California State University-Long Beach","2023","Part-time students, Undergraduate total","Not applicable, undergraduate detail","6640","3038","3602","3294","1393","1901","-2"
"110583","California State University-Long Beach","2023","Part-time students, Undergraduate, Degree/certificate-seeking total","Not applicable, undergraduate detail","6502","2982","3520","3246","1378","1868","-2"
"110583","California State University-Long Beach","2023","Part-time students, Undergraduate, Degree/certificate-seeking, First-time","Not applicable, undergraduate detail","105","51","54","61","23","38","-2"
"110583","California State University-Long Beach","2023","Part-time students, Undergraduate, Degree/certificate-seeking, Other degree/certificate-seeking","Not applicable, undergraduate detail","6397","2931","3466","3185","1355","1830","-2"
"110583","California State University-Long Beach","2023","Part-time students, Undergraduate, Non-degree/certificate-seeking","Not applicable, undergraduate detail","138","56","82","48","15","33","-2"
"110583","California State University-Long Beach","2023","Part-time students, Graduate","Not applicable, undergraduate detail","2934","1147","1787","1349","473","876","-2"
"110583","California State University-Long Beach","2023","Part-time students, Undergraduate, Other degree/certificate-seeking, Transfer-ins","Not applicable, undergraduate detail","997","451","546","549","231","318","-2"
"110583","California State University-Long Beach","2023","Part-time students, Undergraduate, Other degree/certificate-seeking, Continuing","Not applicable, undergraduate detail","5400","2480","2920","2636","1124","1512","-2"
"110592","California State University-Los Angeles","2023","All students total","All students total","28820","11860","16960","20941","8208","12733","-2"
"110592","California State University-Los Angeles","2023","All students, Undergraduate total","Undergraduate","24651","10307","14344","18611","7419","11192","-2"
"110592","California State University-Los Angeles","2023","All students, Undergraduate, Degree/certificate-seeking total","Not applicable, undergraduate detail","24486","10237","14249","18521","7380","11141","-2"
"110592","California State University-Los Angeles","2023","All students, Undergraduate, Degree/certificate-seeking, First-time","Not applicable, undergraduate detail","3897","1769","2128","3151","1425","1726","-2"
"110592","California State University-Los Angeles","2023","All students, Undergraduate, Other degree/certificate-seeking","Not applicable, undergraduate detail","20589","8468","12121","15370","5955","9415","-2"
"110592","California State University-Los Angeles","2023","All students, Undergraduate, Non-degree/certificate-seeking","Not applicable, undergraduate detail","165","70","95","90","39","51","-2"
"110592","California State University-Los Angeles","2023","All students, Graduate","Graduate","4169","1553","2616","2330","789","1541","-2"
"110592","California State University-Los Angeles","2023","All students, Undergraduate, Other degree/certificate-seeking, Transfer-ins","Not applicable, undergraduate detail","3266","1337","1929","2233","863","1370","-2"
"110592","California State University-Los Angeles","2023","All students, Undergraduate, Other degree/certificate-seeking, Continuing","Not applicable, undergraduate detail","17323","7131","10192","13137","5092","8045","-2"
"110592","California State University-Los Angeles","2023","Full-time students total","Not applicable, undergraduate detail","22035","8950","13085","16222","6255","9967","-2"
"110592","California State University-Los Angeles","2023","Full-time students, Undergraduate total","Not applicable, undergraduate detail","19467","8034","11433","14797","5806","8991","-2"
"110592","California State University-Los Angeles","2023","Full-time students, Undergraduate, Degree/certificate-seeking total","Not applicable, undergraduate detail","19431","8016","11415","14794","5803","8991","-2"
"110592","California State University-Los Angeles","2023","Full-time students, Undergraduate, Degree/certificate-seeking, First-time","Not applicable, undergraduate detail","3720","1690","2030","3001","1360","1641","-2"
"110592","California State University-Los Angeles","2023","Full-time students, Undergraduate, Degree/certificate-seeking, Other degree/certificate-seeking","Not applicable, undergraduate detail","15711","6326","9385","11793","4443","7350","-2"
"110592","California State University-Los Angeles","2023","Full-time students, Undergraduate, Non-degree/certificate-seeking","Not applicable, undergraduate detail","36","18","18","3","3","0","-2"
"110592","California State University-Los Angeles","2023","Full-time students, Graduate","Not applicable, undergraduate detail","2568","916","1652","1425","449","976","-2"
"110592","California State University-Los Angeles","2023","Full-time students, Undergraduate, Other degree/certificate-seeking, Transfer-ins","Not applicable, undergraduate detail","2524","1037","1487","1720","667","1053","-2"
"110592","California State University-Los Angeles","2023","Full-time students, Undergraduate, Other degree/certificate-seeking, Continuing","Not applicable, undergraduate detail","13187","5289","7898","10073","3776","6297","-2"
"110592","California State University-Los Angeles","2023","Part-time students total","Not applicable, undergraduate detail","6785","2910","3875","4719","1953","2766","-2"
"110592","California State University-Los Angeles","2023","Part-time students, Undergraduate total","Not applicable, undergraduate detail","5184","2273","2911","3814","1613","2201","-2"
"110592","California State University-Los Angeles","2023","Part-time students, Undergraduate, Degree/certificate-seeking total","Not applicable, undergraduate detail","5055","2221","2834","3727","1577","2150","-2"
"110592","California State University-Los Angeles","2023","Part-time students, Undergraduate, Degree/certificate-seeking, First-time","Not applicable, undergraduate detail","177","79","98","150","65","85","-2"
"110592","California State University-Los Angeles","2023","Part-time students, Undergraduate, Degree/certificate-seeking, Other degree/certificate-seeking","Not applicable, undergraduate detail","4878","2142","2736","3577","1512","2065","-2"
"110592","California State University-Los Angeles","2023","Part-time students, Undergraduate, Non-degree/certificate-seeking","Not applicable, undergraduate detail","129","52","77","87","36","51","-2"
"110592","California State University-Los Angeles","2023","Part-time students, Graduate","Not applicable, undergraduate detail","1601","637","964","905","340","565","-2"
"110592","California State University-Los Angeles","2023","Part-time students, Undergraduate, Other degree/certificate-seeking, Transfer-ins","Not applicable, undergraduate detail","742","300","442","513","196","317","-2"
"110592","California State University-Los Angeles","2023","Part-time students, Undergraduate, Other degree/certificate-seeking, Continuing","Not applicable, undergraduate detail","4136","1842","2294","3064","1316","1748","-2"
"110608","California State University-Northridge","2023","All students total","All students total","41751","18400","23351","22041","9076","12965","-2"
"110608","California State University-Northridge","2023","All students, Undergraduate total","Undergraduate","35488","16189","19299","19805","8389","11416","-2"
"110608","California State University-Northridge","2023","All students, Undergraduate, Degree/certificate-seeking total","Not applicable, undergraduate detail","35309","16132","19177","19747","8375","11372","-2"
"110608","California State University-Northridge","2023","All students, Undergraduate, Degree/certificate-seeking, First-time","Not applicable, undergraduate detail","5037","2391","2646","3265","1481","1784","-2"
"110608","California State University-Northridge","2023","All students, Undergraduate, Other degree/certificate-seeking","Not applicable, undergraduate detail","30272","13741","16531","16482","6894","9588","-2"
"110608","California State University-Northridge","2023","All students, Undergraduate, Non-degree/certificate-seeking","Not applicable, undergraduate detail","179","57","122","58","14","44","-2"
"110608","California State University-Northridge","2023","All students, Graduate","Graduate","6263","2211","4052","2236","687","1549","-2"
"110608","California State University-Northridge","2023","All students, Undergraduate, Other degree/certificate-seeking, Transfer-ins","Not applicable, undergraduate detail","6570","2936","3634","3155","1307","1848","-2"
"110608","California State University-Northridge","2023","All students, Undergraduate, Other degree/certificate-seeking, Continuing","Not applicable, undergraduate detail","23702","10805","12897","13327","5587","7740","-2"
"110608","California State University-Northridge","2023","Full-time students total","Not applicable, undergraduate detail","30715","13472","17243","16987","6909","10078","-2"
"110608","California State University-Northridge","2023","Full-time students, Undergraduate total","Not applicable, undergraduate detail","27776","12420","15356","15871","6582","9289","-2"
"110608","California State University-Northridge","2023","Full-time students, Undergraduate, Degree/certificate-seeking total","Not applicable, undergraduate detail","27717","12402","15315","15869","6582","9287","-2"
"110608","California State University-Northridge","2023","Full-time students, Undergraduate, Degree/certificate-seeking, First-time","Not applicable, undergraduate detail","4963","2355","2608","3220","1459","1761","-2"
"110608","California State University-Northridge","2023","Full-time students, Undergraduate, Degree/certificate-seeking, Other degree/certificate-seeking","Not applicable, undergraduate detail","22754","10047","12707","12649","5123","7526","-2"
"110608","California State University-Northridge","2023","Full-time students, Undergraduate, Non-degree/certificate-seeking","Not applicable, undergraduate detail","59","18","41","2","0","2","-2"
"110608","California State University-Northridge","2023","Full-time students, Graduate","Not applicable, undergraduate detail","2939","1052","1887","1116","327","789","-2"
"110608","California State University-Northridge","2023","Full-time students, Undergraduate, Other degree/certificate-seeking, Transfer-ins","Not applicable, undergraduate detail","4943","2194","2749","2397","994","1403","-2"
"110608","California State University-Northridge","2023","Full-time students, Undergraduate, Other degree/certificate-seeking, Continuing","Not applicable, undergraduate detail","17811","7853","9958","10252","4129","6123","-2"
"110608","California State University-Northridge","2023","Part-time students total","Not applicable, undergraduate detail","11036","4928","6108","5054","2167","2887","-2"
"110608","California State University-Northridge","2023","Part-time students, Undergraduate total","Not applicable, undergraduate detail","7712","3769","3943","3934","1807","2127","-2"
"110608","California State University-Northridge","2023","Part-time students, Undergraduate, Degree/certificate-seeking total","Not applicable, undergraduate detail","7592","3730","3862","3878","1793","2085","-2"
"110608","California State University-Northridge","2023","Part-time students, Undergraduate, Degree/certificate-seeking, First-time","Not applicable, undergraduate detail","74","36","38","45","22","23","-2"
"110608","California State University-Northridge","2023","Part-time students, Undergraduate, Degree/certificate-seeking, Other degree/certificate-seeking","Not applicable, undergraduate detail","7518","3694","3824","3833","1771","2062","-2"
"110608","California State University-Northridge","2023","Part-time students, Undergraduate, Non-degree/certificate-seeking","Not applicable, undergraduate detail","120","39","81","56","14","42","-2"
"110608","California State University-Northridge","2023","Part-time students, Graduate","Not applicable, undergraduate detail","3324","1159","2165","1120","360","760","-2"
"110608","California State University-Northridge","2023","Part-time students, Undergraduate, Other degree/certificate-seeking, Transfer-ins","Not applicable, undergraduate detail","1627","742","885","758","313","445","-2"
"110608","California State University-Northridge","2023","Part-time students, Undergraduate, Other degree/certificate-seeking, Continuing","Not applicable, undergraduate detail","5891","2952","2939","3075","1458","1617","-2"
"110662","University of California-Los Angeles","2023","All students total","All students total","49010","21045","27965","9906","3497","6409","-2"
"110662","University of California-Los Angeles","2023","All students, Undergraduate total","Undergraduate","34398","13711","20687","7697","2607","5090","-2"
"110662","University of California-Los Angeles","2023","All students, Undergraduate, Degree/certificate-seeking total","Not applicable, undergraduate detail","34395","13710","20685","7697","2607","5090","-2"
"110662","University of California-Los Angeles","2023","All students, Undergraduate, Degree/certificate-seeking, First-time","Not applicable, undergraduate detail","6513","2432","4081","1456","412","1044","-2"
"110662","University of California-Los Angeles","2023","All students, Undergraduate, Other degree/certificate-seeking","Not applicable, undergraduate detail","27882","11278","16604","6241","2195","4046","-2"
"110662","University of California-Los Angeles","2023","All students, Undergraduate, Non-degree/certificate-seeking","Not applicable, undergraduate detail","3","1","2","0","0","0","-2"
"110662","University of California-Los Angeles","2023","All students, Graduate","Graduate","14612","7334","7278","2209","890","1319","-2"
"110662","University of California-Los Angeles","2023","All students, Undergraduate, Other degree/certificate-seeking, Transfer-ins","Not applicable, undergraduate detail","3763","1544","2219","949","365","584","-2"
"110662","University of California-Los Angeles","2023","All students, Undergraduate, Other degree/certificate-seeking, Continuing","Not applicable, undergraduate detail","24119","9734","14385","5292","1830","3462","-2"
"110662","University of California-Los Angeles","2023","Full-time students total","Not applicable, undergraduate detail","45781","19305","26476","9358","3219","6139","-2"
"110662","University of California-Los Angeles","2023","Full-time students, Undergraduate total","Not applicable, undergraduate detail","32798","12975","19823","7372","2463","4909","-2"
"110662","University of California-Los Angeles","2023","Full-time students, Undergraduate, Degree/certificate-seeking total","Not applicable, undergraduate detail","32797","12974","19823","7372","2463","4909","-2"
"110662","University of California-Los Angeles","2023","Full-time students, Undergraduate, Degree/certificate-seeking, First-time","Not applicable, undergraduate detail","6497","2430","4067","1453","412","1041","-2"
"110662","University of California-Los Angeles","2023","Full-time students, Undergraduate, Degree/certificate-seeking, Other degree/certificate-seeking","Not applicable, undergraduate detail","26300","10544","15756","5919","2051","3868","-2"
"110662","University of California-Los Angeles","2023","Full-time students, Undergraduate, Non-degree/certificate-seeking","Not applicable, undergraduate detail","1","1","0","0","0","0","-2"
"110662","University of California-Los Angeles","2023","Full-time students, Graduate","Not applicable, undergraduate detail","12983","6330","6653","1986","756","1230","-2"
"110662","University of California-Los Angeles","2023","Full-time students, Undergraduate, Other degree/certificate-seeking, Transfer-ins","Not applicable, undergraduate detail","3646","1512","2134","935","361","574","-2"
"110662","University of California-Los Angeles","2023","Full-time students, Undergraduate, Other degree/certificate-seeking, Continuing","Not applicable, undergraduate detail","22654","9032","13622","4984","1690","3294","-2"
"110662","University of California-Los Angeles","2023","Part-time students total","Not applicable, undergraduate detail","3229","1740","1489","548","278","270","-2"
"110662","University of California-Los Angeles","2023","Part-time students, Undergraduate total","Not applicable, undergraduate detail","1600","736","864","325","144","181","-2"
"110662","University of California-Los Angeles","2023","Part-time students, Undergraduate, Degree/certificate-seeking total","Not applicable, undergraduate detail","1598","736","862","325","144","181","-2"
"110662","University of California-Los Angeles","2023","Part-time students, Undergraduate, Degree/certificate-seeking, First-time","Not applicable, undergraduate detail","16","2","14","3","0","3","-2"
"110662","University of California-Los Angeles","2023","Part-time students, Undergraduate, Degree/certificate-seeking, Other degree/certificate-seeking","Not applicable, undergraduate detail","1582","734","848","322","144","178","-2"
"110662","University of California-Los Angeles","2023","Part-time students, Undergraduate, Non-degree/certificate-seeking","Not applicable, undergraduate detail","2","0","2","0","0","0","-2"
"110662","University of California-Los Angeles","2023","Part-time students, Graduate","Not applicable, undergraduate detail","1629","1004","625","223","134","89","-2"
"110662","University of California-Los Angeles","2023","Part-time students, Undergraduate, Other degree/certificate-seeking, Transfer-ins","Not applicable, undergraduate detail","117","32","85","14","4","10","-2"
"110662","University of California-Los Angeles","2023","Part-time students, Undergraduate, Other degree/certificate-seeking, Continuing","Not applicable, undergraduate detail","1465","702","763","308","140","168","-2"
"117733","Los Angeles Valley College","2023","All students total","All students total","24256","10109","14147","12769","5086","7683","-2"
"117733","Los Angeles Valley College","2023","All students, Undergraduate total","Undergraduate","24256","10109","14147","12769","5086","7683","-2"
"117733","Los Angeles Valley College","2023","All students, Undergraduate, Degree/certificate-seeking total","Not applicable, undergraduate detail","19163","7855","11308","9872","3880","5992","-2"
"117733","Los Angeles Valley College","2023","All students, Undergraduate, Degree/certificate-seeking, First-time","Not applicable, undergraduate detail","3623","1668","1955","1810","813","997","-2"
"117733","Los Angeles Valley College","2023","All students, Undergraduate, Other degree/certificate-seeking","Not applicable, undergraduate detail","15540","6187","9353","8062","3067","4995","-2"
"117733","Los Angeles Valley College","2023","All students, Undergraduate, Non-degree/certificate-seeking","Not applicable, undergraduate detail","5093","2254","2839","2897","1206","1691","-2"
"117733","Los Angeles Valley College","2023","All students, Undergraduate, Other degree/certificate-seeking, Transfer-ins","Not applicable, undergraduate detail","4868","1898","2970","2436","892","1544","-2"
"117733","Los Angeles Valley College","2023","All students, Undergraduate, Other degree/certificate-seeking, Continuing","Not applicable, undergraduate detail","10672","4289","6383","5626","2175","3451","-2"
"117733","Los Angeles Valley College","2023","Full-time students total","Not applicable, undergraduate detail","3294","1531","1763","1706","750","956","-2"
"117733","Los Angeles Valley College","2023","Full-time students, Undergraduate total","Not applicable, undergraduate detail","3294","1531","1763","1706","750","956","-2"
"117733","Los Angeles Valley College","2023","Full-time students, Undergraduate, Degree/certificate-seeking total","Not applicable, undergraduate detail","3224","1497","1727","1661","734","927","-2"
"117733","Los Angeles Valley College","2023","Full-time students, Undergraduate, Degree/certificate-seeking, First-time","Not applicable, undergraduate detail","1147","557","590","636","300","336","-2"
"117733","Los Angeles Valley College","2023","Full-time students, Undergraduate, Degree/certificate-seeking, Other degree/certificate-seeking","Not applicable, undergraduate detail","2077","940","1137","1025","434","591","-2"
"117733","Los Angeles Valley College","2023","Full-time students, Undergraduate, Non-degree/certificate-seeking","Not applicable, undergraduate detail","70","34","36","45","16","29","-2"
"117733","Los Angeles Valley College","2023","Full-time students, Undergraduate, Other degree/certificate-seeking, Transfer-ins","Not applicable, undergraduate detail","261","121","140","115","44","71","-2"
"117733","Los Angeles Valley College","2023","Full-time students, Undergraduate, Other degree/certificate-seeking, Continuing","Not applicable, undergraduate detail","1816","819","997","910","390","520","-2"
"117733","Los Angeles Valley College","2023","Part-time students total","Not applicable, undergraduate detail","20962","8578","12384","11063","4336","6727","-2"
"117733","Los Angeles Valley College","2023","Part-time students, Undergraduate total","Not applicable, undergraduate detail","20962","8578","12384","11063","4336","6727","-2"
"117733","Los Angeles Valley College","2023","Part-time students, Undergraduate, Degree/certificate-seeking total","Not applicable, undergraduate detail","15939","6358","9581","8211","3146","5065","-2"
"117733","Los Angeles Valley College","2023","Part-time students, Undergraduate, Degree/certificate-seeking, First-time","Not applicable, undergraduate detail","2476","1111","1365","1174","513","661","-2"
"117733","Los Angeles Valley College","2023","Part-time students, Undergraduate, Degree/certificate-seeking, Other degree/certificate-seeking","Not applicable, undergraduate detail","13463","5247","8216","7037","2633","4404","-2"
"117733","Los Angeles Valley College","2023","Part-time students, Undergraduate, Non-degree/certificate-seeking","Not applicable, undergraduate detail","5023","2220","2803","2852","1190","1662","-2"
"117733","Los Angeles Valley College","2023","Part-time students, Undergraduate, Other degree/certificate-seeking, Transfer-ins","Not applicable, undergraduate detail","4607","1777","2830","2321","848","1473","-2"
"117733","Los Angeles Valley College","2023","Part-time students, Undergraduate, Other degree/certificate-seeking, Continuing","Not applicable, undergraduate detail","8856","3470","5386","4716","1785","2931","-2"
"117788","Los Angeles City College","2023","All students total","All students total","23627","9815","13812","12595","5140","7455","-2"
"117788","Los Angeles City College","2023","All students, Undergraduate total","Undergraduate","23627","9815","13812","12595","5140","7455","-2"
"117788","Los Angeles City College","2023","All students, Undergraduate, Degree/certificate-seeking total","Not applicable, undergraduate detail","18586","7781","10805","9351","3862","5489","-2"
"117788","Los Angeles City College","2023","All students, Undergraduate, Degree/certificate-seeking, First-time","Not applicable, undergraduate detail","3249","1489","1760","1498","711","787","-2"
"117788","Los Angeles City College","2023","All students, Undergraduate, Other degree/certificate-seeking","Not applicable, undergraduate detail","15337","6292","9045","7853","3151","4702","-2"
"117788","Los Angeles City College","2023","All students, Undergraduate, Non-degree/certificate-seeking","Not applicable, undergraduate detail","5041","2034","3007","3244","1278","1966","-2"
"117788","Los Angeles City College","2023","All students, Undergraduate, Other degree/certificate-seeking, Transfer-ins","Not applicable, undergraduate detail","5738","2261","3477","2834","1047","1787","-2"
"117788","Los Angeles City College","2023","All students, Undergraduate, Other degree/certificate-seeking, Continuing","Not applicable, undergraduate detail","9599","4031","5568","5019","2104","2915","-2"
"117788","Los Angeles City College","2023","Full-time students total","Not applicable, undergraduate detail","6477","2847","3630","3239","1438","1801","-2"
"117788","Los Angeles City College","2023","Full-time students, Undergraduate total","Not applicable, undergraduate detail","6477","2847","3630","3239","1438","1801","-2"
"117788","Los Angeles City College","2023","Full-time students, Undergraduate, Degree/certificate-seeking total","Not applicable, undergraduate detail","6206","2749","3457","3085","1387","1698","-2"
"117788","Los Angeles City College","2023","Full-time students, Undergraduate, Degree/certificate-seeking, First-time","Not applicable, undergraduate detail","1393","665","728","689","337","352","-2"
"117788","Los Angeles City College","2023","Full-time students, Undergraduate, Degree/certificate-seeking, Other degree/certificate-seeking","Not applicable, undergraduate detail","4813","2084","2729","2396","1050","1346","-2"
"117788","Los Angeles City College","2023","Full-time students, Undergraduate, Non-degree/certificate-seeking","Not applicable, undergraduate detail","271","98","173","154","51","103","-2"
"117788","Los Angeles City College","2023","Full-time students, Undergraduate, Other degree/certificate-seeking, Transfer-ins","Not applicable, undergraduate detail","884","381","503","389","161","228","-2"
"117788","Los Angeles City College","2023","Full-time students, Undergraduate, Other degree/certificate-seeking, Continuing","Not applicable, undergraduate detail","3929","1703","2226","2007","889","1118","-2"
"117788","Los Angeles City College","2023","Part-time students total","Not applicable, undergraduate detail","17150","6968","10182","9356","3702","5654","-2"
"117788","Los Angeles City College","2023","Part-time students, Undergraduate total","Not applicable, undergraduate detail","17150","6968","10182","9356","3702","5654","-2"
"117788","Los Angeles City College","2023","Part-time students, Undergraduate, Degree/certificate-seeking total","Not applicable, undergraduate detail","12380","5032","7348","6266","2475","3791","-2"
"117788","Los Angeles City College","2023","Part-time students, Undergraduate, Degree/certificate-seeking, First-time","Not applicable, undergraduate detail","1856","824","1032","809","374","435","-2"
"117788","Los Angeles City College","2023","Part-time students, Undergraduate, Degree/certificate-seeking, Other degree/certificate-seeking","Not applicable, undergraduate detail","10524","4208","6316","5457","2101","3356","-2"
"117788","Los Angeles City College","2023","Part-time students, Undergraduate, Non-degree/certificate-seeking","Not applicable, undergraduate detail","4770","1936","2834","3090","1227","1863","-2"
"117788","Los Angeles City College","2023","Part-time students, Undergraduate, Other degree/certificate-seeking, Transfer-ins","Not applicable, undergraduate detail","4854","1880","2974","2445","886","1559","-2"
"117788","Los Angeles City College","2023","Part-time students, Undergraduate, Other degree/certificate-seeking, Continuing","Not applicable, undergraduate detail","5670","2328","3342","3012","1215","1797","-2"
"122977","Santa Monica College","2023","All students total","All students total","32856","14425","18431","12853","5343","7510","-2"
"122977","Santa Monica College","2023","All students, Undergraduate total","Undergraduate","32856","14425","18431","12853","5343","7510","-2"
"122977","Santa Monica College","2023","All students, Undergraduate, Degree/certificate-seeking total","Not applicable, undergraduate detail","29522","12910","16612","11831","4924","6907","-2"
"122977","Santa Monica College","2023","All students, Undergraduate, Degree/certificate-seeking, First-time","Not applicable, undergraduate detail","7457","3441","4016","2685","1173","1512","-2"
"122977","Santa Monica College","2023","All students, Undergraduate, Other degree/certificate-seeking","Not applicable, undergraduate detail","22065","9469","12596","9146","3751","5395","-2"
"122977","Santa Monica College","2023","All students, Undergraduate, Non-degree/certificate-seeking","Not applicable, undergraduate detail","3334","1515","1819","1022","419","603","-2"
"122977","Santa Monica College","2023","All students, Undergraduate, Other degree/certificate-seeking, Transfer-ins","Not applicable, undergraduate detail","3523","1463","2060","1349","539","810","-2"
"122977","Santa Monica College","2023","All students, Undergraduate, Other degree/certificate-seeking, Continuing","Not applicable, undergraduate detail","18542","8006","10536","7797","3212","4585","-2"
"122977","Santa Monica College","2023","Full-time students total","Not applicable, undergraduate detail","9790","4595","5195","3687","1576","2111","-2"
"122977","Santa Monica College","2023","Full-time students, Undergraduate total","Not applicable, undergraduate detail","9790","4595","5195","3687","1576","2111","-2"
"122977","Santa Monica College","2023","Full-time students, Undergraduate, Degree/certificate-seeking total","Not applicable, undergraduate detail","9691","4538","5153","3660","1557","2103","-2"
"122977","Santa Monica College","2023","Full-time students, Undergraduate, Degree/certificate-seeking, First-time","Not applicable, undergraduate detail","3878","1827","2051","1528","652","876","-2"
"122977","Santa Monica College","2023","Full-time students, Undergraduate, Degree/certificate-seeking, Other degree/certificate-seeking","Not applicable, undergraduate detail","5813","2711","3102","2132","905","1227","-2"
"122977","Santa Monica College","2023","Full-time students, Undergraduate, Non-degree/certificate-seeking","Not applicable, undergraduate detail","99","57","42","27","19","8","-2"
"122977","Santa Monica College","2023","Full-time students, Undergraduate, Other degree/certificate-seeking, Transfer-ins","Not applicable, undergraduate detail","609","275","334","237","106","131","-2"
"122977","Santa Monica College","2023","Full-time students, Undergraduate, Other degree/certificate-seeking, Continuing","Not applicable, undergraduate detail","5204","2436","2768","1895","799","1096","-2"
"122977","Santa Monica College","2023","Part-time students total","Not applicable, undergraduate detail","23066","9830","13236","9166","3767","5399","-2"
"122977","Santa Monica College","2023","Part-time students, Undergraduate total","Not applicable, undergraduate detail","23066","9830","13236","9166","3767","5399","-2"
"122977","Santa Monica College","2023","Part-time students, Undergraduate, Degree/certificate-seeking total","Not applicable, undergraduate detail","19831","8372","11459","8171","3367","4804","-2"
"122977","Santa Monica College","2023","Part-time students, Undergraduate, Degree/certificate-seeking, First-time","Not applicable, undergraduate detail","3579","1614","1965","1157","521","636","-2"
"122977","Santa Monica College","2023","Part-time students, Undergraduate, Degree/certificate-seeking, Other degree/certificate-seeking","Not applicable, undergraduate detail","16252","6758","9494","7014","2846","4168","-2"
"122977","Santa Monica College","2023","Part-time students, Undergraduate, Non-degree/certificate-seeking","Not applicable, undergraduate detail","3235","1458","1777","995","400","595","-2"
"122977","Santa Monica College","2023","Part-time students, Undergraduate, Other degree/certificate-seeking, Transfer-ins","Not applicable, undergraduate detail","2914","1188","1726","1112","433","679","-2"
"122977","Santa Monica College","2023","Part-time students, Undergraduate, Other degree/certificate-seeking, Continuing","Not applicable, undergraduate detail","13338","5570","7768","5902","2413","3489","-2"
"125471","West Los Angeles College","2023","All students total","All students total","17492","6828","10664","8567","3156","5411","-2"
"125471","West Los Angeles College","2023","All students, Undergraduate total","Undergraduate","17492","6828","10664","8567","3156","5411","-2"
"125471","West Los Angeles College","2023","All students, Undergraduate, Degree/certificate-seeking total","Not applicable, undergraduate detail","13850","5371","8479","6805","2493","4312","-2"
"125471","West Los Angeles College","2023","All students, Undergraduate, Degree/certificate-seeking, First-time","Not applicable, undergraduate detail","2162","985","1177","957","387","570","-2"
"125471","West Los Angeles College","2023","All students, Undergraduate, Other degree/certificate-seeking","Not applicable, undergraduate detail","11688","4386","7302","5848","2106","3742","-2"
"125471","West Los Angeles College","2023","All students, Undergraduate, Non-degree/certificate-seeking","Not applicable, undergraduate detail","3642","1457","2185","1762","663","1099","-2"
"125471","West Los Angeles College","2023","All students, Undergraduate, Other degree/certificate-seeking, Transfer-ins","Not applicable, undergraduate detail","5032","1876","3156","2574","931","1643","-2"
"125471","West Los Angeles College","2023","All students, Undergraduate, Other degree/certificate-seeking, Continuing","Not applicable, undergraduate detail","6656","2510","4146","3274","1175","2099","-2"
"125471","West Los Angeles College","2023","Full-time students total","Not applicable, undergraduate detail","1671","700","971","908","355","553","-2"
"125471","West Los Angeles College","2023","Full-time students, Undergraduate total","Not applicable, undergraduate detail","1671","700","971","908","355","553","-2"
"125471","West Los Angeles College","2023","Full-time students, Undergraduate, Degree/certificate-seeking total","Not applicable, undergraduate detail","1657","694","963","903","353","550","-2"
"125471","West Los Angeles College","2023","Full-time students, Undergraduate, Degree/certificate-seeking, First-time","Not applicable, undergraduate detail","409","211","198","225","101","124","-2"
"125471","West Los Angeles College","2023","Full-time students, Undergraduate, Degree/certificate-seeking, Other degree/certificate-seeking","Not applicable, undergraduate detail","1248","483","765","678","252","426","-2"
"125471","West Los Angeles College","2023","Full-time students, Undergraduate, Non-degree/certificate-seeking","Not applicable, undergraduate detail","14","6","8","5","2","3","-2"
"125471","West Los Angeles College","2023","Full-time students, Undergraduate, Other degree/certificate-seeking, Transfer-ins","Not applicable, undergraduate detail","262","88","174","135","41","94","-2"
"125471","West Los Angeles College","2023","Full-time students, Undergraduate, Other degree/certificate-seeking, Continuing","Not applicable, undergraduate detail","986","395","591","543","211","332","-2"
"125471","West Los Angeles College","2023","Part-time students total","Not applicable, undergraduate detail","15821","6128","9693","7659","2801","4858","-2"
"125471","West Los Angeles College","2023","Part-time students, Undergraduate total","Not applicable, undergraduate detail","15821","6128","9693","7659","2801","4858","-2"
"125471","West Los Angeles College","2023","Part-time students, Undergraduate, Degree/certificate-seeking total","Not applicable, undergraduate detail","12193","4677","7516","5902","2140","3762","-2"
"125471","West Los Angeles College","2023","Part-time students, Undergraduate, Degree/certificate-seeking, First-time","Not applicable, undergraduate detail","1753","774","979","732","286","446","-2"
"125471","West Los Angeles College","2023","Part-time students, Undergraduate, Degree/certificate-seeking, Other degree/certificate-seeking","Not applicable, undergraduate detail","10440","3903","6537","5170","1854","3316","-2"
"125471","West Los Angeles College","2023","Part-time students, Undergraduate, Non-degree/certificate-seeking","Not applicable, undergraduate detail","3628","1451","2177","1757","661","1096","-2"
"125471","West Los Angeles College","2023","Part-time students, Undergraduate, Other degree/certificate-seeking, Transfer-ins","Not applicable, undergraduate detail","4770","1788","2982","2439","890","1549","-2"
"125471","West Los Angeles College","2023","Part-time students, Undergraduate, Other degree/certificate-seeking, Continuing","Not applicable, undergraduate detail","5670","2115","3555","2731","964","1767","-2"
